{
    "boxInfo":
        [
            {"size_x":11,"size_y":11}
        ],
    "innerBoxes":
        [{
            "pan":[
                ["# ", "# ", "# ", "# ", "# ", "# ", "# ", "# ", "# ", "# ", "# "],
                ["# ", "P ", ". ", ". ", ". ", ". ", ". ", ". ", ". ", "= ", "# "],
                [". ", ". ", ". ", ". ", ". ", ". ", ". ", ". ", ". ", ". ", "# "],
                [". ", ". ", ". ", ". ", ". ", ". ", ". ", ". ", ". ", ". ", "# "],
                [". ", ". ", ". ", "O ", ". ", ". ", ". ", ". ", ". ", ". ", "# "],
                [". ", ". ", ". ", ". ", "O ", ". ", ". ", ". ", ". ", ". ", "# "],
                [". ", ". ", ". ", ". ", ". ", "O ", "- ", "- ", "- ", "# ", "# "],
                [". ", ". ", ". ", ". ", ". ", ". ", ". ", ". ", ". ", ". ", "# "],
                [". ", ". ", ". ", ". ", ". ", ". ", ". ", ". ", ". ", "- ", "# "],
                ["O ", "o ", ". ", ". ", ". ", ". ", ". ", ". ", ". ", ". ", "# "],
                ["# ", "# ", "# ", "# ", "# ", "# ", "# ", "# ", "# ", "# ", "# "]
              ]
        }]
}