{
    "boxInfo":
        [
            {"size_x":9,"size_y":9}
        ],
    "innerBoxes":
        [{
            "pan":[
              [ "# ", ". ", ". ", "# ", "# ", "# ", "# ", "# ", ". " ],
              [ "# ", "# ", "# ", "# ", ". ", ". ", ". ", "# ", ". " ],
              [ "# ", "# ", "- ", ". ", ". ", "O ", ". ", "# ", ". " ],
              [ "# ", "# ", "# ", "# ", ". ", "O ", ". ", "# ", ". " ],
              [ "# ", "# ", "- ", "# ", "# ", "O ", "= ", "# ", ". " ],
              [ "# ", "# ", ". ", "# ", ". ", "- ", "P ", "# ", "# " ],
              [ "# ", "# ", "O ", ". ", "O ", ". ", ". ", "O ", "# " ],
              [ "# ", "# ", ". ", ". ", ". ", "O ", "O ", ". ", "# " ],
              [ "# ", "# ", "# ", "# ", "# ", "# ", "# ", "# ", "# " ]
              ]
        }]
}